0 0 0
5 4 10
.U#D#....D
..#....#..
..####.#.D
.......#..
..#U#D....
....#.....
....#####.
..........
.....D....
..........
..........
.........U
..........
..........
..........
.........U
..........
..........
..........
.........U
